1111111111111111111111111111111111
1E0101011000110C00000C000000000001
1010010100100000101001000000010101
1010010010101010001001000000010101
1P0011000C01C0000000011111100010C1
1111111111111111111111111111111111
