11111111111111111
1E001011111111111
10100000000000001
1010C0CCCCCCCCCC1
1P001C11111111111
11111111111111111
