11111111111111111
1E001011111111111
1010000000X00X001
1010C0CCCCCCCCCC1
1P001C11111111111
11111111111111111
