111111111111111
1E001001100C001
1010C0010010101
101000000010101
1P001C10C100C11
111111111111111
