111111111111111111111111111111111
1PE000000000C0C00000C00000C0100C1
101001010010000010100110010010101
101001C0101010100010010101C010101
101001001010101000100101010010101
101001001010101000100101010010101
101001001010101000100101010010101
101001001010101000100101010010101
100000000C00C00000C00000C00000001
111111111111111111111111111111111