111111111111111111111111111111111
1E0000000000XX0C00000C00000000001
101001010010000010100110010010101
101001X0101010100010010101X010101
101001001010101000100101010010101
101001001010101000100101010010101
101001001010101000100101010010101
101001001010101000100101010010101
1P0000000C00C00000X00000C000000C1
111111111111111111111111111111111