111111111111111111111111111111111111111111
1XXXXXXXXXXXXXXXXXXXXXXXXXXXXXXXXXXXXXXXX1
1X1XX1X1XX1XXXXX1X1XX1XXXXXXXXXXXXX1X1XXX1
1X1XX1XX1X1X1X1XXX1XX1XXXXXXX1XXXXX1X1XXX1
1XXXXXXXXXXXXXXXXXXXXXXXXXXXXXXXXXXXXXXXX1
111111111111111111111111111111111111111XX1
1X1XX1XX1X1X1X1XXX1XX1XXXEXXX1XXXXX1X1XXX1
1X1XX1XX1X1X1X1XXX1XX1XXXXXXX1XXXXX1X1XXX1
1X1XX1XX1X1X1X1XXX1XX1XXXXXXX1XXXXX1X1XXX1
1X1XX1XX1X1X1X1XXX1XX1XXXXXXX1XXXXX1X1XXX1
1X1XX1XX1X1X1X1XXX1XX1XXXXXXX1XXXXX1X1XXX1
1X1XX1X1XX1XXXXX1X1XX1XXCXXXXXXXXXX1X1XXX1
101001XX1X1X1X1XXX1XX1XXXXXXX1XXXXX1X1XXX1
100P001XXXXXXXXXXXXXXXXXXXXXXXXXXXXXXXXXX1
111111111111111111111111111111111111111111