111111111111111111111111111111111111111111
1CCCCCCCCCCCCCCCCCCCCCCCCCCCCCCCCCCCCCCCC1
1C1CC1C1CC1CCCCC1C1CC1CCCCCCCCCCCCC1C1CCC1
1C1CC1CC1C1C1C1CCC1CC1CCCCCCC1CCCCC1C1CCC1
1CCCCCCCCCCCCCCCCCCCCCCCCCCCCCCCCCCCCCCCC1
111111111111111111111111111111111111111CC1
1C1CC1CC1C1C1C1CCC1CC1CCCECCC1CCCCC1C1CCC1
1C1CC1CC1C1C1C1CCC1CC1CCCCCCC1CCCCC1C1CCC1
1C1CC1CC1C1C1C1CCC1CC1CCCCCCC1CCCCC1C1CCC1
1C1CC1CC1C1C1C1CCC1CC1CCCCCCC1CCCCC1C1CCC1
1C1CC1CC1C1C1C1CCC1CC1CCCCCCC1CCCCC1C1CCC1
1C1CC1C1CC1CCCCC1C1CC1CCCCCCCCCCCCC1C1CCC1
1C1CC1CC1C1C1C1CCC1CC1CCCCCCC1CCCCC1C1CCC1
1CCPCCCCCCCCCCCCCCCCCCCCCCCCCCCCCCCCCCCCC1
111111111111111111111111111111111111111111