11111111111111111111111111111111111111111111111111111111111111111111
100000000000000C00000C0000000000000000000000000C00000C00000000000001
10100101001000001010010000000101001001010010000010100100000001010001
10100100101010100010010000000101001001001010101000100100000001010001
100000000C00C0000000000000000000C00000000C00C0000000000000000000C001
11111111111111111111111111111111111111111111111111111111111111111001
11111111111111111111111111111111111111111111111111111111111111111001
100000000000000C00000C0000000000000000000000000C00000C00000000000001
10100101001000001010010000000101001001010010000010100100000001010001
10100100101P1010001001000000010100100100101010100010010000E001010001
100000000C00C0000000000000000000C00000000C00C0000000000000000000C001
11111111111111111111111111111111111111111111111111111111111111111001
11111111111111111111111111111111111111111111111111111111111111111001
100000000000000C00000C0000000000000000000000000C00000C00000000000001
10100101001000001010010000000101001001010010000010100100000001010001
10100100101010100010010000000101001001001010101000100100000001010001
100000000C00C0000000000000000000C00000000C00C0000000000000000000C001
11111111111111111111111111111111111111111111111111111111111111111111