1111111111111
10X00C0ECC0C1
100X001111001
1P0000X00X001
1111111111111