1111111111111
10000C0ECC0C1
100X001111001
1P00010000001
1111111111111