1111111111111
100000CE00001
101X001111C01
1P1000X00X001
1111111111111