111111111111111111111
1E000X00C00X000000001
1010X10110000X0010101
1010000010X0000010101
1010X10110000X0010101
1010X10110000X0010101
1010X10110000X0010101
1010X10110000X0010101
1010X10110000X0010101
1010010010X0000010101
1010010010X0000010101
1P10010010X0000010101
111111111111111111111