1111111111111111111111111111111111
1E000X000000000C00000C00X000000001
1010X1010010X0001010010000X0010101
10100100101010100010010X0000010101
1P0000000C00C00000000X0000000000C1
1111111111111111111111111111111111