111111111111111111111111111111111
1PE000000000XX0C00000C000000100C1
101001010010000010100110010010101
101001X0101010100010010101X010101
101001001010101000100101010010101
101001001010101000100101010010101
101001001010101000100101010010101
101001001010101000100101010010101
100000000C00C00000X00000C00000001
111111111111111111111111111111111